#^.^~****^*~~.~^~..~~~^~.^~.*~**.^^*^*^~..*^^..~^.
*#*~*#~^^^~~.*~*.**.~~^*^**.^~*^^.*^...^..^.**.~^*
^^#*#~##^*^..^**.~~~.~*.~^^~^~^.^~^*~**.~*^.^**.*.
*~~#~^.~#~^~^^*^**.~.*^^*~~^^*~.^.*^^*^.^.~~^^^*~.
*.^~^^.~^#^.^^*~^~~*^..^~^~~^.*^^..**.**~.~~^~*~**
^.^^~^.*~*##*~*^*~^*~~^.^.~.~^**~.^^^^*.~.~~~^^.^.
*~~.*.^~~~^*#^*~~~*^.^**^*^.^.^~~***^^*^.~^^.^^.~.
.~.*~~^*.**#~^^~**^.^.^~~~^.~.^~~^^.~^^.^^~.~.~.*^
.^^^~~*~.^.~#*~.~~..~*~^.~**~..^****~.*~^~~*~**^~^
^^^*^^**...*#^^*^^^.*~*~^^~*~~.~****~~~~***.^^~~^~
..*^^^^^.^~#^~#^#^^~*~^*~**^*^.~~~*^.^^~**~*~.....
**.^~~~^~*~*##*#*#^~#^##^^^~.^...~.**^^^^~^.~^~.~*
^*~.*.~*^.~.^^^^^#~#*#~^#*^*.~~..^~~~*~*^.~~^*^*^^
~*^.^..**~**^*^~**#^~~*^*#*~..~^^***^.*~.^*^^^^.~.
*~^~^**^^*^^~^*~^^*~~~*^#~~~~*~^^^*~..~~~~~.*~^~*.
^.*.^*^**^^^~**.*.~^~~~^.#~~~*~~^*~..^^.^~*.^~^~**
.***^..*^~~~~^~.*^~~.*.~^#^^*.***^~^.*....~.^.*~^^
^^~~~~.**.*.^^*.^~~^....*~#^~*^^.^~~~^*#~^^^~**^~~
^~~*^*.~.*^^^*^.*..~*...~*#^.^^~.^^.^##^#^**.^^..*
~^***~^.~.~^^^*~~~.*..^~^^#~^.~.**###~^~*#~^~~**^~
~~~^~.^*.^*.~*.*~~^..~*^^~~#*.#.##~^^^..^#~^.*.^~~
^^~...^.*~.^^**~^~*..^~^~*..##^#^^**~.*.^^##.~*~.*
^..^...~.~.*.~***~*~~*..~*~^^~~^~**^~~^*^^~*#~*^*^
*^.**^~*****.~~~..~^~.*.^*~^.^^*^..*~^.^.^*.^#~^^*
~...~*^....*^.*^^*...^.~~..^.*~.*~.*^.^*^*^.**#*^~
^..~***^.*^~~.****.~*^.~.^~*.~^*^~^.****~..~*.#*^~
.~^~**~^^..~~~^..*~*.^**~..^^*.~.*..*~~*~.^~.~#~~.
.***~..~**^.~.~.~*.~~**..^.^~..~*~~~~*.**~~^..^#^^
~.*.~^*^*~^.~*..*~^~~.*.*..*.*..^~.*~^^*.~^.^~^*#^
.*^~^^*.^*.~*...*~~~*.**.~...*.*^.^*.^*~*.^~^**^*#
.~..*....~..~.***~..~^..~~^*^*^~^^~~**^.*~**^**^^#
^.*.~.^.**^*^.~^^*.~..*^~*^***.~**..^.~~*..^*^~*#~
^~~^~~*.~^^~~^**.^.^^^*^.*^^~~.^.*~^*^^..**..**.#^
^.^*.*^..*.~~.^^***^.*~..~.**^*.~^...^^~*.~^~^.#~~
~^^.^..*^^.**.~~^*~*^~*~^~~.~*.^~.~*^~*.*..^.^^#^*
^^.~*^~~*.~~*~.^..~*.^.~**.^*^.^~.**.~*.~...~~#.*.
.~..^.~.~.^*.~^*~.~.*^*~~*.^.******~*~~*^~~~^#~~*~
~.*..^^*^~*.~~.~.^~..~.~^^^.*~*.**~^*~*^*^^~.#^~^^
*.^*^**^*.^^*....**..~^^~.^*^.*~*^**^^..*.^^#^^^.~
^*^~^^*.~*~^*~^~~.*.^*^~*^^~.*~.*~.**.*~^~~.~#^~~*
~~**~*.^.*~..~~^^^~^^^.~***^*.^*~^*~^~*~**...~##~.
*~**^~~.^.*.~^**~*^^.*^*.^~~*~~~*^.*..~~^*^.*^.^#*
.*^~..*~.*^^^^^~~^^*.~*.~~~.***~^.*..~~******~~^*#
.^^..^.^*^~^.~*...**~~~.**^*~~~*^***~^*^~^~~^^^*#*
**.**~.**~.*.*^~~.~^.*^.~~*.^*.~.***~*^^..~*.~*^#^
~..^.****^.****~^~***..^^^^*^.~*^^*.~~.^**^*~^*#~~
^*~^.~*...^^.^~.^^..~^...**...^****^*~*~*^..~^*~#~
...^~^.~^^~~~~.*^~.^~***~~^^^.*^^.~.^*~*~**^***^~#
.~~~~~^^.~~*^.~^^^**~^~.^~^~*..^*~^^*..*~^~**.*.^#
~^**.~**..*^~^^^.^*^~^~*^.~*~.^.**.^.^^.~**^~~^~^#
